SFHFFHFF
FFFFFFFF
FFFFFFFF
HFFFHFFF
HFFFFFFF
FFFFHFFH
FHFFFHFH
FFFFFFFG
