SFFHFFFH
FFFFFFFF
FFHFFFFH
FFFFFFFF
FFFFFFFF
FFHFFHFF
FFFHFFFF
FFFFFFFG
