SFFFFFHF
FFFHFFFF
FFFFFHFH
FFFHFHFF
HFFFFFFF
FFFHFFFH
FFFHFFFF
FFFFFFHG
