SFFFHFFH
FHFFFFFF
FFFFHFFF
FFFFHFFH
FFFFFFFF
FFFFFFFH
FFFHFFFF
FFFHHFFG
