SFFHFFHH
FFFHFFFF
FFFHFFFF
FFFFHHFF
FFFFFFFF
FFFFFFFF
HHFFFFFF
FFFHHHFG
